0000H-00000000000000 
0000--0000000000D000
L
0000000000000000K000
D00000000S0000000000
L
00000000000000000000
00A000K0000000D00000
L
0000K000000000000000
000000000000000S0000
L
00D00000000000000000
000A00000000000000D0
L
00000000000000000000
00000G0000000000G000
L
00000000000000000000
00000000000000000000
background 2(создаёт по цифре)

s - speed
a - armor
g - gun
k - knight
d - dragon
h - house
l - line